###############################################
1     #     #   #             #               2
##### # ### # # # ######### ### ########### ###
#   # #   #   # # #         #   #   # #   #   #
# # # ### ##### # # ####### # ### # # # # ### #
# #   #   #   # # # #   #   #     #   # #   # #
# ####### # ### # # # # # ####### ##### ### # #
#       # #   #   #   # # #   #   #     # # # #
####### # ### ######### # # # # ### ##### # # #
#   #   # #   #     #   #   # #   # #         #
# # # ### # # ### # # ########### # ######### #
# #   # #   #     # #   #       # #         # #
# ##### ########### ### # ### ### ######### ###
# #     #     #       #   #   #   #       #   #
# # ### # # ### ######### # ### ### ### ##### #
# # #   # #     #   #   # #         #   #     #
# # ### # ##### # # # # ############# ### ### #
# #   # # #   #   # # #         #       #   # #
# # # ### # # # ##### ######### ########### ###
# # #     # # # #   # #   #   #   #       #   #
# ####### # # # # # # # ### # ### # ##### ### #
#       # # # # # #   # #   #   # # #   # #   #
####### ### # ### ##### # ##### # # # # # # # #
#           #     #           #     # #     # #
###############################################
