###############################################
# #     #             #     #     #         # #
# ### # ##### ##### # ### # # ### ### # ### # #
1     #     #     # #     # #   #   # # # #   #
########### ##### # ####### ### ### # # # ### #
#     #   #     # # #     #   #   # # # #   # #
# ##### # ##### ### # # ##### ### # # # # ### #
#       #     # #   # #     #     # # # #   # #
# ######### # # # ######### ####### ### # # # #
#   #     # # #   #   #   #       #     # #   2
### ### ### # ##### # # # ####### ####### #####
#   #   #   #       # # # #           #   #   #
# ### ### # ######### # # # ######### # ### # #
#     #   # #     #     #   #   #     #   # # #
##### # ### # ### ########### # # ####### ### #
# #   # #   # #   #   #       #   #     # #   #
# # ### ##### # ### # ##### ####### ### # # # #
# # # #   #   #   # # #   # #     #   #   # # #
# # # ### # ##### # # # # ### ### ### ##### # #
#   #   #   # #   # #   # #   #   #   #     # #
# ### ####### # # # ##### # ### ### ##### ### #
# #           # # #   # #   #   #   #     # # #
# ######### # # ##### # ##### ### ##### ### # #
#           # #             #           #     #
###############################################
