###############################################
#       #         #   #       #     #         #
####### ####### # # # ####### # # # ##### ### #
#     #         #   # #     #   # #       # # #
# # # ############### # ### ### # ######### # #
# # # #           # #   # #   # # #       # # #
### # # # ####### # ##### ### ### ### ### # # #
#   # # #     # #   #       #     #   #     # #
# ##### ##### # ### ##### ######### ### ##### #
#     # #     # #   #     #         # #   #   #
# ### # # ##### # ### ### # ####### # ### # ###
# # #   #     # #     #   # #     # #     # # #
1 # ######### # ####### ### ### ### # ##### # 2
#         #   #       #   # #   #   #   #   # #
### ##### # ### ##### ### # # ### ####### ### #
#   #   # #   # #   # #   # #   #     #   #   #
# ### # ##### # ### # # ### ### ##### # ### # #
# #   # #     #   #   # # #     #     #   # # #
# # ### # ##### # ##### # ##### # # ##### # ###
# # # #   #     #           #   # # #     #   #
# # # ##### ########### ##### ### ### ####### #
# # #           #     # #   # #   #   #       #
# # ############# ### ### # # # ### ### ##### #
# #                 #     #   #         #     #
###############################################
