###############################################
# #     #     #   #         #       #   #     #
# # # # ##### # # # ##### # # ### ### # # ### #
# # # #     #   #   # #   # # #   #   #     # #
# ### ##### # ####### # ### ### # # ######### #
#   #     # #         # #   #   # #       #   #
### # ### # # ######### # ### ########### # ###
1 # # #   # # #         #   # #   #     # #   #
# # ### ### ### ########### # # # # ### # ### #
# #     # #     #         # #   #   # #   # # #
# ####### ####### ### ##### # ####### ##### # #
#     #   #   #   # # #     #     #       # # #
# ### # # # # # ### # # ######### # ##### # # #
# #   # # # #   #   #   #     #   #   # #   # #
# # ##### # ####### ##### ### # ##### # # ### #
# #       #   #       # #   #         # # #   2
# ### ####### # # ### # # ############# # # # #
#   # #   #   # #   # #   #       #       # # #
### # # # # ### ### # ### # ##### ######### # #
#   # # #   # # #   #   # # #   #           # #
# ##### ##### # # ##### # # ### ############# #
#     #     #   # # #   # # #         #     # #
# ### ##### ##### # # ##### # ######### ### # #
#   #             #         #             #   #
###############################################
