###############################################
# #       # #   #     #       # #             #
# ### ### # # # # ### # # ### # # ########### #
#     # # #   #     #   # # # #           # # #
####### # # ############# # # ########### # # #
#       # #   #     #   # # #   #         # # #
# ### ### # ### ### # # # # ### # ##### ### # #
#   #   # # #   #     #   #     # #   #     # #
### ### # ### ############# ####### # ####### #
#   # # #   #     #     #   #       #         #
# ### # ### ### # # ### # ### ############### #
#     #   #   # # #   # # #   #   #     #   # #
# ##### # ### ### # ### # ### # ### # # # # # #
# #     # # #   # # #   #     #   # # # # # # #
# # ##### # ### # # # ######### # # # ### # # #
# #     # # #   #   # #     #   #   #   # #   #
# ##### # # # ####### # ### # ######### # #####
1 #     #   #         # # #   #       # # #   2
### # ################# # ######### # # # # # #
#   # #   #           #   #         # #   # # #
# ##### # # ##### ### ### ### ####### ####### #
# #     # #     #   #   #     # #   #   #     #
# # ##### ##### ### ########### # # ### ### # #
#       #         #               #         # #
###############################################
