###############################################
# # #     #   #   #         # #     #     #   #
# # # # # # ### # # ### ### # # # # # ### # # #
# #   # # #     # #   #   # #   # #   #   # # #
# # ### # ### ### ### ### # ##### ##### ### # #
# # #   #   #   #       # #     #     # #   # #
# # # ##### ############# ##### ### # # ### # #
# # # #   #               #   #   # # #     # 2
# ### # ##################### ### ### #########
# #   #                   #     #   #         #
# # ### ######### # ##### # ### ### # ####### #
#   #   #     #   # #   #   #   #   #       # #
##### ### ##### ### # # # ####### ########### #
#   #     #   # #   # # # #       #         # #
# # ##### # # # # ### # ### ####### # ##### # #
# #     # # #   # # # #     #     # # #   #   #
# ##### # # ##### # # ####### ### # # ### ### #
# #     # # #       #   # #   #   # #   # #   #
# # ### # # ####### ### # # # ### ##### # # ###
# #   # # #     # #   # #   #   #       # #   #
# ### # # ##### # ### # ####### ######### ### #
# # # # # #   # #     #       #   # #       # #
# # # ### # # # ############# ### # # ##### # #
1   #       # #                   #       #   #
###############################################
