###############################################
1             #       #       #     #         #
############# # ##### # # ### # # ### ####### #
#   #   #     #     #   #   # # #     # #     #
# # # # # ##### ########### # ####### # # #####
# #   # #     # #         # # #     #   # #   #
# ########### ### ####### # # # ### ### # # # #
#   #       #   # #     #   # # #   #   #   # #
# # # ##### ### # # ### ##### # # ########### #
# #   #   #   #   # #       #   #       #     #
# ##### ### ####### # ##### ########### # ### #
# #       # #       # #   #   #   #     #   # #
# ####### # # ####### # # ### # # # ####### # #
# #   #   # #   # #   # # #     # #   #     # #
# # # # ### ### # # ### # # ######### # ##### #
# # # #   #       #   # #   #       #   #   # #
# # # ### ########### ####### ##### ##### # # #
#   #     #   #       #   #   #   #     # # # #
######### # # # ####### # # ### # # # ### # # #
#   #   #   # #     #   #   # # #   # #   #   #
# # # # ##### ##### # ####### # ##### # #######
# # # #   #   #   # #   #     # #     #   #   #
# # # ### # ### # # ### # ### # ######### # # #
# #     #       # #       #   #             # 2
###############################################
