###############################################
1     #   #           #                   #   3
##### # # # ######### ##### ##### ####### ### #
#   #   #   #   #   #     # #     # #   #   # #
### ######### # # # ##### ### ##### # # ### # #
#           # # # # #   #   #   #   # #   # # #
# ####### ### # # # # # ### # # # # # # ### # #
# #     # #   #   #   #   # # # # # # #     # #
# # ### ### ############# # ### # ### ####### #
#   # #   #         #   # #   # #     #       #
# ### ### ######### ### # ### # # ##### # #####
# #     #     #   #     #   #   #   #   #     #
# # # ####### # # ##### ### ####### ####### # #
# # #     #   # # #     # # #       #     # # #
# # ### # # ### # # ##### # # ####### ### ### #
# # #   # #     #   #     #   #     #   #     #
# ### ### ############### ##### ##### # ##### #
#     #   #   #             #     #   # # #   #
####### ### # ##### ####### ##### # ### # # ###
#       #   #   #   #     #     #   #   #   # #
# ######### ### # ### ### ##### ##### ### ### #
#   #     # # # # # # #     #   #     #   #   #
### # ### # # # # # # # ##### ### ##### ### # #
#     #     #     #   #           #         # #
###############################################
