###############################################
#     #       #       #   #       #     #     2
### # ### ### ### ### ### # ### ### ### ### # #
#   #   # #   #   #   #   #   #     #     # # #
# ##### # # ### ### ### ##### ##### ### ### # #
#     # #     #   # #     #     #   #   #   # #
### # # ##### ### # ##### ### ### ### # ### ###
#   #     #   #   #     #   # #     # #   #   #
# ##### ### ### ##### # ### ### ### # ### ### #
#     #     #     #   #     #     #       #   #
### ### ### ### ##### ### ### ######### ##### #
#   # # #   #     #   #   # #     #     #     #
# ### # # ### ### # ### ### ##### ### ### ### #
# #   #   #   # # #     #     #     # #   # # #
# # ##### ### # ### ### ### # ### ### # ### # #
# #     #     #   # #   #   #   #     #     # #
# ##### # ##### # # # ### ##### # ######### # #
#     # #   #   #   # #     #     #         # #
### # ##### # ######### ### ##### ### ##### # #
#   #     # # #       #   #   #     #   # #   #
# ### ### # # # ##### ### ### ### ### # # ### #
#     #   #         # #   #   # #     #   #   #
### ### ########### # # ### # # ### ####### ###
1     # #           #       # #     #         #
###############################################
