###############################################
#   #       #             #               #   #
### # ##### ####### ### # # ########### # ### #
# #   # #   #     #   # # #           # #   # #
# ##### # ### ### ### # ########### ### ### # #
#       #     #   # # #           # #   #     #
# # ### ####### ### # ### ##### ### # # ##### #
# #   #   #   #   #     # #     #   # # #   # 2
# ### ### # ##### # ##### ### ### ### ### # ###
#   # # # # #     # #   #   # #   # # #   #   #
# ### # # # # ####### # ### ### ### # # ##### #
# #   # #   # #       #   #   #     #       # #
# # ### ### # ### ####### ### ##### ##### ### #
1 #   #   # #   #   #   #     #     #   # #   #
##### # # # ### # # # # ### ### ##### # ### # #
#     # #   #   # # # # #   #       # #     # #
# ########### ### # # # ##### ####### ####### #
# #   #   #   #   #   #         #   #   #   # #
# # # # # # ### ############### # # ### # ### #
#   #   # #   # #       #     # # #   # #   # #
# ####### ### # # ##### # ### ### ### # # # # #
# #     # #   # # #     # # #     # # # # # # #
# ##### # # ##### # ##### # ####### # # # # # #
#       #         #       #             # #   #
###############################################
