###############################################
#                                             #
#  #1  #1  ###1  #1  #1   #1  #1 ###1 #1  #1  #
#  #1  #1 #1  #1 #1  #1   #1  #1  #1  ##1 #1  #
#   #1#1  #1  #1 #1  #1   #1#1#1  #1  #1#1#1  #
#    #1   #1  #1 #1  #1   #1#1#1  #1  #1 ##1  #
#    #1    ###1   ###1     #1#1  ###1 #1  #1  #
#                                             #
#                                             #
#                    6666                     #
#                  66666666                   #
#                666666666666                 #
#              6666666666666666               #
#              6666666666666666               #
#              4466666666666655               #
#              4444666666665555               #
#              4444446666555555               #
#              4444444455555555               #
#              4444444455555555               #
#              4444444455555555               #
#                444444555555                 #
#                  44445555                   #
#                    4455                     #
#                                             #
###############################################
